5,7
1,2
00000000
00E00000
00999900
00900000
00900000
00000000
00000000